11 11 1
WWWWWWWWWWW
WWW000WWWWW
W0WbWwWWWwW
W0WWw+w00BW
W00WWSWWWwW
WW0WW0WWWwW
WWwwWW0000W
WWWwWW00WWW
Gww00000WWW
WWWwWWWWWWW
WWWWWWWWWWW