17 17 1
W0D000000W0GWWW00
W0WWWWWW000W0000W
00W0W00WWWWW00W0W
0WW0W00000W00W0Wa
0000W0WWWWW00W0W0
W0eWW0000W00000W0
00WW00WW0W0CWW000
0W000WWW0WW0W0WWW
0000W000S000W0000
0WW0W0WW0WW0WWW00
0W00W00W0W0BW0000
0W0W00WWAW0W00000
0W0W0WcW0W0W0W000
000W00EWbW000W000
0WWWWW0WWWWWWW000
0WWW000W000000000
00000WWWdW0W0W0W0