19 11 3
WWWWWWWWWWWWWWWWWWW
WWWWW000WWWWWWWWWWW
WWWWWx00WWWWWWWWWWW
WWWWW00xWWWWWWWWWWW
WWW00x0x0WWWWWWWWWW
WWW0W0WW0WWWWWWWWWW
W000W0WW0WWWWW00ssW
W0x00x0000000000ssW
WWWWW0WWW0WSWW00ssW
WWWWW00000WWWWWWWWW
WWWWWWWWWWWWWWWWWWW
