9 9 3
WWWWWWWWW
W000WWWWW
W0x0WWWWW
W0x0WWWsW
WWW0WWWsW
WWW0000sW
WW0x0W00W
WW00SWWWW
WWWWWWWWW