11 5 1
SW*WW00W0WW
000000wbWGW
WWWWW0WWWwW
WW+W00WW0BW
W000000000W