13 11 3
WWWWWWWWWWWWW
WssssW000WWWW
WssssW00000WW
WW000W0x0x0WW
WW000WWxWSWWW
WW000W000xWWW
WW0W0W00xx0WW
WW000xx0000WW
WW00WW00000WW
WWWWWWWWWWWWW
WWWWWWWWWWWWW
