10 5
SW0000WWWG
0WAWW00000
0W0WaWWWWW
0W0WB000Wb
000000W000