10 10
cWa0W000WS
A0W0WWW0W0
W000000000
GWWWWWBWWC
00W00000Wb
W0WWWWW0WD
00W000W0W0
0000WWd0W0
0WWWWWWWW0
0000000000